-3 -3 -3 -3 -3 -3 -3 -3 -3 -3 -3 -3 -3 -3 -3 -3 -3 -3 -3 -3 -3 -3 -3 -3 -3 -3 -3 -3 -3 -3 -3 -3 -3 -3 -3 -3 -3 -3 -3 -3 -3 -3 -3 -3 -3 -3 -3 -3 -3 -3 -3 -3 -3 -3 -3 -3 -3 -3 -3 -3 -3 -3 -3 -3 -3 -3 -3 -3 -3 -3 -3 -3 -3 -3 -3 -3 -3 -3 -3 -3 -3 -3 -3 -3 -3 -3 -3 -3 -3 -3 -3 -3 -3 -3 -3 -3 -3 -3 -3 -3 -3 -3 -3 -3 -3 -3 -3 -3 -3 -3 -3 -3 -3 -3 -3 -3 -3 -3 -3 -3 -3 -3 -3 -3 -3 -3 -3 -3 -3 -3 -3 -3 -3 -3 -3 -3 -3 -3 -3 -3 -3 -3 -3 -3 -3 -3 -3 -3 -3 -3 -3 -3 -3 -3 -3 -3 -3 -3 -3 -3 -3 -3 -3 -3 -3 -3 -3 -3 -3 -3 -3 -3 -3 -3 -3 -3 -3 -3 -3 -3 -3 -3 -3 -3 -3 -3 -3 -3 -3 -3 -3 -3 -3 -3 -3 -3 -3 -3 -3 -3 -3 -3 -3 -3 -3 -3 -3 -3 -3 -3 -3 -3 -3 -3 -3 -3 -3 -3 -3 -3 -3 -3 -3 -3 -3 -3 -3 -3 -3 -3 -3 -3 -3 -3 -3 -3 -3 -3 -3 -3 -3 -3 -3 -3 -3 -3 -3 -3 -3 -3 -3 -3 -3 -3 -3 -3 -3 -3 -3 -3 -3 -3 -3 -3 -3 -3 -3 -3 -3 -3 -3 -3 -3 -3 -3 -3 -3 -3 -3 -3 -3 -3 -3 -3
-3 -3 -3 -3 -3 -3 -3 -3 -3 -3 -3 -3 -3 -3 -3 -3 -3 -3 -3 -3 -3 -3 -3 -3 -3 -3 -3 -3 -3 -3 -3 -3 -3 -3 -3 -3 -3 -3 -3 -3 -3 -3 -3 -3 -3 -3 -3 -3 -3 -3 -3 -3 -3 -3 -3 -3 -3 -3 -3 -3 -3 -3 -3 -3 -3 -3 -3 -3 -3 -3 -3 -3 -3 -3 -3 -3 -3 -3 -3 -3 -3 -3 -3 -3 -3 -3 -3 -3 -3 -3 -3 -3 -3 -3 -3 -3 -3 -3 -3 -3 -3 -3 -3 -3 -3 -3 -3 -3 -3 -3 -3 -3 -3 -3 -3 -3 -3 -3 -3 -3 -3 -3 -3 -3 -3 -3 -3 -3 -3 -3 -3 -3 -3 -3 -3 -3 -3 -3 -3 -3 -3 -3 -3 -3 -3 -3 -3 -3 -3 -3 -3 -3 -3 -3 -3 -3 -3 -3 -3 -3 -3 -3 -3 -3 -3 -3 -3 -3 -3 -3 -3 -3 -3 -3 -3 -3 -3 -3 -3 -3 -3 -3 -3 -3 -3 -3 -3 -3 -3 -3 -3 -3 -3 -3 -3 -3 -3 -3 -3 -3 -3 -3 -3 -3 -3 -3 -3 -3 -3 -3 -3 -3 -3 -3 -3 -3 -3 -3 -3 -3 -3 -3 -3 -3 -3 -3 -3 -3 -3 -3 -3 -3 -3 -3 -3 -3 -3 -3 -3 -3 -3 -3 -3 -3 -3 -3 -3 -3 -3 -3 -3 -3 -3 -3 -3 -3 -3 -3 -3 -3 -3 -3 -3 -3 -3 -3 -3 -3 -3 -3 -3 -3 -3 -3 -3 -3 -3 -3 -3 -3 -3 -3 -3 -3
-3 -3 -3 -3 -3 -3 -3 -3 -3 -3 -3 -3 -3 -3 -3 -3 -3 -3 -3 -3 -3 -3 -3 -3 -3 -3 -3 -3 -3 -3 -3 -3 -3 -3 -3 -3 -3 -3 -3 -3 -3 -3 -3 -3 -3 -3 -3 -3 -3 -3 -3 -3 -3 -3 -3 -3 -3 -3 -3 -3 -3 -3 -3 -3 -3 -3 -3 -3 -3 -3 -3 -3 -3 -3 -3 -3 -3 -3 -3 -3 -3 -3 -3 -3 -3 -3 -3 -3 -3 -3 -3 -3 -3 -3 -3 -3 -3 -3 -3 -3 -3 -3 -3 -3 -3 -3 -3 -3 -3 -3 -3 -3 -3 -3 -3 -3 -3 -3 -3 -3 -3 -3 -3 -3 -3 -3 -3 -3 -3 -3 -3 -3 -3 -3 -3 -3 -3 -3 -3 -3 -3 -3 -3 -3 -3 -3 -3 -3 -3 -3 -3 -3 -3 -3 -3 -3 -3 -3 -3 -3 -3 -3 -3 -3 -3 -3 -3 -3 -3 -3 -3 -3 -3 -3 -3 -3 -3 -3 -3 -3 -3 -3 -3 -3 -3 -3 -3 -3 -3 -3 -3 -3 -3 -3 -3 -3 -3 -3 -3 -3 -3 -3 -3 -3 -3 -3 -3 -3 -3 -3 -3 -3 -3 -3 -3 -3 -3 -3 -3 -3 -3 -3 -3 -3 -3 -3 -3 -3 -3 -3 -3 -3 -3 -3 -3 -3 -3 -3 -3 -3 -3 -3 -3 -3 -3 -3 -3 -3 -3 -3 -3 -3 -3 -3 -3 -3 -3 -3 -3 -3 -3 -3 -3 -3 -3 -3 -3 -3 -3 -3 -3 -3 -3 -3 -3 -3 -3 -3 -3 -3 -3 -3 -3 -3
-3 -3 -3 -3 -3 -3 -3 -3 -3 -3 -3 -3 -3 -3 -3 -3 -3 -3 -3 -3 -3 -3 -3 -3 -3 -3 -3 -3 -3 -3 -3 -3 -3 -3 -3 -3 -3 -3 -3 -3 -3 -3 -3 -3 -3 -3 -3 -3 -3 -3 -3 -3 -3 -3 -3 -3 -3 -3 -3 -3 -3 -3 -3 -3 -3 -3 -3 -3 -3 -3 -3 -3 -3 -3 -3 -3 -3 -3 -3 -3 -3 -3 -3 -3 -3 -3 -3 -3 -3 -3 -3 -3 -3 -3 -3 -3 -3 -3 -3 -3 -3 -3 -3 -3 -3 -3 -3 -3 -3 -3 -3 -3 -3 -3 -3 -3 -3 -3 -3 -3 -3 -3 -3 -3 -3 -3 -3 -3 -3 -3 -3 -3 -3 -3 -3 -3 -3 -3 -3 -3 -3 -3 -3 -3 -3 -3 -3 -3 -3 -3 -3 -3 -3 -3 -3 -3 -3 -3 -3 -3 -3 -3 -3 -3 -3 -3 -3 -3 -3 -3 -3 -3 -3 -3 -3 -3 -3 -3 -3 -3 -3 -3 -3 -3 -3 -3 -3 -3 -3 -3 -3 -3 -3 -3 -3 -3 -3 -3 -3 -3 -3 -3 -3 -3 -3 -3 -3 -3 -3 -3 -3 -3 -3 -3 -3 -3 -3 -3 -3 -3 -3 -3 -3 -3 -3 -3 -3 -3 -3 -3 -3 -3 -3 -3 -3 -3 -3 -3 -3 -3 -3 -3 -3 -3 -3 -3 -3 -3 -3 -3 -3 -3 -3 -3 -3 -3 -3 -3 -3 -3 -3 -3 -3 -3 -3 -3 -3 -3 -3 -3 -3 -3 -3 -3 -3 -3 -3 -3 -3 -3 -3 -3 -3 -3
-3 -3 -3 -3 -3 -3 -3 09 09 09 09 09 09 09 -3 -3 -3 -3 -3 -3 -3 -3 -3 -3 -3 -3 -3 -3 09 09 09 09 09 09 09 09 09 09 09 09 09 09 09 -3 -3 -3 -3 -3 -3 -3 -3 -3 -3 -3 -3 -3 -3 -3 09 09 09 09 09 09 09 09 09 09 09 09 09 09 09 -3 -3 -3 -3 -3 -3 -3 -3 -3 -3 -3 -3 -3 -3 -3 -3 -3 -3 -3 -3 09 09 09 09 09 09 09 09 09 -3 -3 -3 -3 -3 -3 -3 -3 -3 -3 -3 -3 09 09 09 09 09 09 09 09 09 09 09 09 09 09 09 09 09 09 -3 -3 -3 -3 -3 -3 -3 -3 -3 -3 -3 -3 -3 -3 -3 -3 -3 -3 -3 09 09 09 09 09 09 09 09 -3 -3 -3 -3 -3 -3 -3 -3 -3 -3 -3 -3 -3 09 09 09 09 09 09 09 09 09 09 09 09 09 09 09 09 09 09 09 09 -3 -3 -3 -3 -3 -3 -3 -3 -3 -3 -3 -3 -3 -3 -3 09 09 09 09 09 09 09 09 09 -3 -3 -3 -3 -3 -3 -3 -3 -3 -3 -3 -3 -3 -3 -3 -3 -3 -3 -3 -3 09 09 09 09 09 09 09 09 09 -3 -3 -3 -3 -3 -3 -3 -3 -3 -3 -3 -3 -3 -3 -3 -3 -3 -3 -3 -3 09 09 09 09 09 09 09 09 09 -3 -3 -3 -3 -3 -3 -3 -3 -3 -3
-3 -3 -3 -3 -3 -3 09 04 04 04 04 04 04 09 -3 -3 -3 -3 -3 -3 -3 -3 -3 -3 -3 -3 -3 09 04 04 04 04 04 04 04 04 04 04 04 04 04 04 04 09 09 -3 -3 -3 -3 -3 -3 -3 -3 -3 -3 -3 -3 09 04 04 04 04 04 04 04 04 04 04 04 04 04 04 04 09 09 -3 -3 -3 -3 -3 -3 -3 -3 -3 -3 -3 -3 -3 -3 -3 -3 -3 09 04 04 04 04 04 04 04 04 09 -3 -3 -3 -3 -3 -3 -3 -3 -3 -3 -3 -3 09 04 04 04 04 04 04 04 04 04 04 04 04 04 04 04 04 09 -3 -3 -3 -3 -3 -3 -3 -3 -3 -3 -3 -3 -3 -3 -3 -3 -3 -3 09 04 04 04 04 04 04 09 -3 -3 -3 -3 -3 -3 -3 -3 -3 -3 -3 -3 -3 -3 09 04 04 04 04 04 04 04 04 04 04 04 04 04 04 04 04 04 04 09 -3 -3 -3 -3 -3 -3 -3 -3 -3 -3 -3 -3 -3 09 09 04 04 04 04 04 04 04 04 04 09 09 -3 -3 -3 -3 -3 -3 -3 -3 -3 -3 -3 -3 -3 -3 -3 -3 09 09 04 04 04 04 04 04 04 04 04 09 09 -3 -3 -3 -3 -3 -3 -3 -3 -3 -3 -3 -3 -3 -3 -3 -3 09 09 04 04 04 04 04 04 04 04 04 09 09 -3 -3 -3 -3 -3 -3 -3 -3
-3 -3 -3 -3 -3 09 04 04 04 04 04 04 04 09 -3 -3 -3 -3 -3 -3 -3 -3 -3 -3 -3 -3 -3 09 04 04 04 04 04 04 09 09 09 09 09 09 04 04 04 04 04 09 -3 -3 -3 -3 -3 -3 -3 -3 -3 -3 -3 09 04 04 04 04 04 04 09 09 09 09 09 04 04 04 04 04 04 09 -3 -3 -3 -3 -3 -3 -3 -3 -3 -3 -3 -3 -3 -3 -3 09 04 04 04 04 04 04 04 04 04 09 -3 -3 -3 -3 -3 -3 -3 -3 -3 -3 -3 -3 09 04 04 04 04 04 04 04 04 04 04 04 04 04 04 04 04 09 -3 -3 -3 -3 -3 -3 -3 -3 -3 -3 -3 -3 -3 -3 -3 -3 -3 09 04 04 04 04 04 04 09 -3 -3 -3 -3 -3 -3 -3 -3 -3 -3 -3 -3 -3 -3 -3 09 04 04 04 04 04 04 04 04 04 04 04 04 04 04 04 04 04 04 09 -3 -3 -3 -3 -3 -3 -3 -3 -3 -3 -3 09 09 04 04 04 04 04 04 04 04 04 04 04 04 04 09 09 -3 -3 -3 -3 -3 -3 -3 -3 -3 -3 -3 -3 09 09 04 04 04 04 04 04 04 04 04 04 04 04 04 09 09 -3 -3 -3 -3 -3 -3 -3 -3 -3 -3 -3 -3 09 09 04 04 04 04 04 04 04 04 04 04 04 04 04 09 09 -3 -3 -3 -3 -3 -3
-3 -3 -3 -3 -3 09 09 09 04 04 04 04 04 09 -3 -3 -3 -3 -3 -3 -3 -3 -3 -3 -3 -3 -3 09 09 09 09 09 09 09 -3 -3 -3 -3 -3 09 04 04 04 04 04 09 -3 -3 -3 -3 -3 -3 -3 -3 -3 -3 -3 09 09 09 09 09 09 09 -3 -3 -3 -3 -3 09 04 04 04 04 04 09 -3 -3 -3 -3 -3 -3 -3 -3 -3 -3 -3 -3 -3 -3 09 04 04 04 04 04 04 04 04 04 04 09 -3 -3 -3 -3 -3 -3 -3 -3 -3 -3 -3 -3 09 04 04 04 04 04 09 09 09 09 09 09 09 09 09 09 09 09 -3 -3 -3 -3 -3 -3 -3 -3 -3 -3 -3 -3 -3 -3 -3 -3 09 04 04 04 04 04 04 09 -3 -3 -3 -3 -3 -3 -3 -3 -3 -3 -3 -3 -3 -3 -3 -3 09 09 09 09 09 09 09 09 09 09 09 09 04 04 04 04 04 04 04 09 -3 -3 -3 -3 -3 -3 -3 -3 -3 -3 09 04 04 04 04 04 04 09 09 09 09 09 04 04 04 04 04 04 09 -3 -3 -3 -3 -3 -3 -3 -3 -3 -3 09 04 04 04 04 04 04 09 09 09 09 09 04 04 04 04 04 04 09 -3 -3 -3 -3 -3 -3 -3 -3 -3 -3 09 04 04 04 04 04 04 04 09 09 09 04 04 04 04 04 04 04 09 -3 -3 -3 -3 -3
-3 -3 -3 -3 -3 -3 -3 -3 09 04 04 04 04 09 -3 -3 -3 -3 -3 -3 -3 -3 -3 -3 -3 -3 -3 -3 -3 -3 -3 -3 -3 -3 -3 -3 -3 -3 -3 09 04 04 04 04 04 09 -3 -3 -3 -3 -3 -3 -3 -3 -3 -3 -3 -3 -3 -3 -3 -3 -3 -3 -3 -3 -3 -3 -3 09 04 04 04 04 04 09 -3 -3 -3 -3 -3 -3 -3 -3 -3 -3 -3 -3 -3 09 04 04 04 04 04 -3 04 04 04 04 04 09 -3 -3 -3 -3 -3 -3 -3 -3 -3 -3 -3 -3 09 04 04 04 04 04 09 -3 -3 -3 -3 -3 -3 -3 -3 -3 -3 -3 -3 -3 -3 -3 -3 -3 -3 -3 -3 -3 -3 -3 -3 -3 -3 09 04 04 04 04 04 04 09 -3 -3 -3 -3 -3 -3 -3 -3 -3 -3 -3 -3 -3 -3 -3 -3 -3 -3 -3 -3 -3 -3 -3 -3 -3 -3 -3 -3 09 04 04 04 04 04 04 09 -3 -3 -3 -3 -3 -3 -3 -3 -3 -3 -3 09 04 04 04 04 04 09 -3 -3 -3 -3 -3 09 04 04 04 04 04 09 -3 -3 -3 -3 -3 -3 -3 -3 -3 -3 09 04 04 04 04 04 09 -3 -3 -3 -3 -3 09 04 04 04 04 04 09 -3 -3 -3 -3 -3 -3 -3 -3 -3 -3 09 04 04 04 04 04 04 09 -3 -3 -3 09 04 04 04 04 04 04 09 -3 -3 -3 -3 -3
-3 -3 -3 -3 -3 -3 -3 -3 09 04 04 04 04 09 -3 -3 -3 -3 -3 -3 -3 -3 -3 -3 -3 -3 -3 -3 -3 -3 -3 -3 -3 -3 -3 -3 -3 -3 -3 09 04 04 04 04 04 09 -3 -3 -3 -3 -3 -3 -3 -3 -3 -3 -3 -3 -3 -3 -3 -3 -3 -3 -3 -3 -3 -3 -3 09 04 04 04 04 04 09 -3 -3 -3 -3 -3 -3 -3 -3 -3 -3 -3 -3 09 04 04 04 04 04 -3 -3 04 04 04 04 04 09 -3 -3 -3 -3 -3 -3 -3 -3 -3 -3 -3 -3 09 04 04 04 04 04 09 -3 -3 -3 -3 -3 -3 -3 -3 -3 -3 -3 -3 -3 -3 -3 -3 -3 -3 -3 -3 -3 -3 -3 -3 -3 09 04 04 04 04 04 04 09 -3 -3 -3 -3 -3 -3 -3 -3 -3 -3 -3 -3 -3 -3 -3 -3 -3 -3 -3 -3 -3 -3 -3 -3 -3 -3 -3 -3 09 04 04 04 04 04 04 09 -3 -3 -3 -3 -3 -3 -3 -3 -3 -3 -3 -3 09 04 04 04 04 04 09 -3 -3 -3 -3 -3 09 04 04 04 04 04 09 -3 -3 -3 -3 -3 -3 -3 -3 -3 -3 09 04 04 04 04 04 09 -3 -3 -3 -3 -3 09 04 04 04 04 04 09 -3 -3 -3 -3 -3 -3 -3 -3 -3 -3 09 04 04 04 04 04 09 -3 -3 -3 -3 -3 09 04 04 04 04 04 09 -3 -3 -3 -3 -3
-3 -3 -3 -3 -3 -3 -3 -3 09 04 04 04 04 09 -3 -3 -3 -3 -3 -3 -3 -3 -3 -3 -3 -3 -3 -3 -3 -3 -3 -3 -3 -3 -3 -3 09 09 09 09 04 04 04 04 09 -3 -3 -3 -3 -3 -3 -3 -3 -3 -3 -3 -3 -3 -3 -3 -3 09 09 09 09 09 09 09 09 04 04 04 04 04 09 -3 -3 -3 -3 -3 -3 -3 -3 -3 -3 -3 -3 09 04 04 04 04 04 -3 -3 -3 04 04 04 04 04 09 -3 -3 -3 -3 -3 -3 -3 -3 -3 -3 -3 -3 09 04 04 04 04 04 09 09 09 09 09 09 09 09 09 09 -3 -3 -3 -3 -3 -3 -3 -3 -3 -3 -3 -3 -3 -3 -3 09 04 04 04 04 04 04 09 -3 -3 -3 -3 -3 -3 -3 -3 -3 -3 -3 -3 -3 -3 -3 -3 -3 -3 -3 -3 -3 -3 -3 -3 -3 -3 -3 -3 09 04 04 04 04 04 04 09 -3 -3 -3 -3 -3 -3 -3 -3 -3 -3 -3 -3 -3 -3 09 04 04 04 04 04 09 09 09 09 09 04 04 04 04 04 09 -3 -3 -3 -3 -3 -3 -3 -3 -3 -3 -3 -3 09 04 04 04 04 04 09 09 09 09 09 04 04 04 04 04 04 09 -3 -3 -3 -3 -3 -3 -3 -3 -3 -3 09 04 04 04 04 04 09 -3 -3 -3 -3 -3 09 04 04 04 04 04 09 -3 -3 -3 -3 -3
-3 -3 -3 -3 -3 -3 -3 -3 09 04 04 04 04 09 -3 -3 -3 -3 -3 -3 -3 -3 -3 -3 -3 -3 -3 -3 -3 -3 -3 09 09 09 09 09 04 04 04 04 04 04 09 09 -3 -3 -3 -3 -3 -3 -3 -3 -3 -3 -3 -3 -3 -3 -3 -3 -3 09 04 04 04 04 04 04 04 04 04 04 04 09 -3 -3 -3 -3 -3 -3 -3 -3 -3 -3 -3 -3 09 04 04 04 04 04 04 04 04 04 04 04 04 04 04 09 09 09 -3 -3 -3 -3 -3 -3 -3 -3 -3 -3 09 04 04 04 04 04 04 04 04 04 04 04 04 04 04 04 09 -3 -3 -3 -3 -3 -3 -3 -3 -3 -3 -3 -3 -3 09 04 04 04 04 04 04 04 04 09 09 09 09 09 -3 -3 -3 -3 -3 -3 -3 -3 -3 -3 -3 -3 -3 -3 -3 -3 -3 -3 -3 -3 -3 -3 09 04 04 04 04 04 04 09 -3 -3 -3 -3 -3 -3 -3 -3 -3 -3 -3 -3 -3 -3 -3 -3 09 04 04 04 04 04 04 04 04 04 04 04 04 04 09 -3 -3 -3 -3 -3 -3 -3 -3 -3 -3 -3 -3 -3 -3 09 09 04 04 04 04 04 04 04 04 04 04 04 04 04 04 09 -3 -3 -3 -3 -3 -3 -3 -3 -3 -3 09 04 04 04 04 04 09 -3 09 09 09 -3 09 04 04 04 04 04 09 -3 -3 -3 -3 -3
-3 -3 -3 -3 -3 -3 -3 -3 09 04 04 04 04 09 -3 -3 -3 -3 -3 -3 -3 -3 -3 -3 -3 -3 -3 -3 -3 09 09 04 04 04 04 04 04 04 04 09 09 09 -3 -3 -3 -3 -3 -3 -3 -3 -3 -3 -3 -3 -3 -3 -3 -3 -3 -3 -3 09 09 09 09 09 09 09 09 04 04 04 04 04 09 -3 -3 -3 -3 -3 -3 -3 -3 -3 -3 -3 09 04 04 04 04 04 04 04 04 04 04 04 04 04 04 04 04 09 -3 -3 -3 -3 -3 -3 -3 -3 -3 -3 09 09 09 09 09 09 09 09 09 09 09 09 04 04 04 04 04 09 -3 -3 -3 -3 -3 -3 -3 -3 -3 -3 -3 09 04 04 04 04 04 04 04 04 04 04 04 04 04 04 09 09 -3 -3 -3 -3 -3 -3 -3 -3 -3 -3 -3 -3 -3 -3 -3 -3 -3 -3 -3 09 04 04 04 04 04 04 09 -3 -3 -3 -3 -3 -3 -3 -3 -3 -3 -3 -3 -3 -3 -3 -3 09 04 04 04 04 04 09 09 09 09 09 04 04 04 04 04 09 -3 -3 -3 -3 -3 -3 -3 -3 -3 -3 -3 -3 -3 -3 -3 09 09 09 09 09 04 04 04 04 04 04 04 04 09 -3 -3 -3 -3 -3 -3 -3 -3 -3 -3 -3 09 04 04 04 04 04 09 -3 09 09 09 -3 09 04 04 04 04 04 09 -3 -3 -3 -3 -3
-3 -3 -3 -3 -3 -3 -3 -3 09 04 04 04 04 09 -3 -3 -3 -3 -3 -3 -3 -3 -3 -3 -3 -3 -3 -3 09 04 04 04 04 04 09 09 09 09 09 -3 -3 -3 -3 -3 -3 -3 -3 -3 -3 -3 -3 -3 -3 -3 -3 -3 -3 -3 -3 -3 -3 -3 -3 -3 -3 -3 -3 -3 -3 09 04 04 04 04 04 09 -3 -3 -3 -3 -3 -3 -3 -3 -3 -3 09 09 09 09 09 09 09 09 09 09 09 04 04 04 04 09 09 09 -3 -3 -3 -3 -3 -3 -3 -3 -3 -3 -3 -3 -3 -3 -3 -3 -3 -3 -3 -3 -3 -3 09 04 04 04 04 04 09 -3 -3 -3 -3 -3 -3 -3 -3 -3 -3 09 04 04 04 04 04 04 09 09 09 09 09 04 04 04 04 04 09 -3 -3 -3 -3 -3 -3 -3 -3 -3 -3 -3 -3 -3 -3 -3 -3 -3 09 04 04 04 04 04 04 09 -3 -3 -3 -3 -3 -3 -3 -3 -3 -3 -3 -3 -3 -3 -3 -3 09 04 04 04 04 04 09 -3 -3 -3 -3 -3 09 04 04 04 04 04 09 -3 -3 -3 -3 -3 -3 -3 -3 -3 -3 -3 -3 -3 -3 -3 -3 -3 -3 -3 09 04 04 04 04 04 04 09 -3 -3 -3 -3 -3 -3 -3 -3 -3 -3 -3 -3 09 04 04 04 04 04 09 -3 -3 -3 -3 -3 09 04 04 04 04 04 09 -3 -3 -3 -3 -3
-3 -3 -3 -3 -3 -3 -3 -3 09 04 04 04 04 09 -3 -3 -3 -3 -3 -3 -3 -3 -3 -3 -3 -3 -3 09 04 04 04 04 04 09 -3 -3 -3 -3 -3 -3 -3 -3 -3 -3 -3 -3 -3 -3 -3 -3 -3 -3 -3 -3 -3 -3 -3 -3 -3 -3 -3 -3 -3 -3 -3 -3 -3 -3 -3 09 04 04 04 04 04 09 -3 -3 -3 -3 -3 -3 -3 -3 -3 -3 -3 -3 -3 -3 -3 -3 -3 -3 -3 -3 09 04 04 04 04 09 -3 -3 -3 -3 -3 -3 -3 -3 -3 -3 -3 -3 -3 -3 -3 -3 -3 -3 -3 -3 -3 -3 -3 -3 09 04 04 04 04 04 09 -3 -3 -3 -3 -3 -3 -3 -3 -3 -3 09 04 04 04 04 04 09 -3 -3 -3 -3 -3 09 04 04 04 04 04 09 -3 -3 -3 -3 -3 -3 -3 -3 -3 -3 -3 -3 -3 -3 -3 09 04 04 04 04 04 04 09 -3 -3 -3 -3 -3 -3 -3 -3 -3 -3 -3 -3 -3 -3 -3 -3 -3 09 04 04 04 04 04 09 -3 -3 -3 -3 -3 09 04 04 04 04 04 09 -3 -3 -3 -3 -3 -3 -3 -3 -3 -3 -3 -3 -3 -3 -3 -3 -3 -3 09 04 04 04 04 04 04 09 -3 -3 -3 -3 -3 -3 -3 -3 -3 -3 -3 -3 -3 09 04 04 04 04 04 09 -3 -3 -3 -3 -3 09 04 04 04 04 04 09 -3 -3 -3 -3 -3
-3 -3 -3 -3 -3 -3 -3 -3 09 04 04 04 04 09 -3 -3 -3 -3 -3 -3 -3 -3 -3 -3 -3 -3 -3 09 04 04 04 04 04 09 -3 -3 -3 -3 -3 -3 -3 -3 -3 -3 -3 -3 -3 -3 -3 -3 -3 -3 -3 -3 -3 -3 -3 -3 -3 -3 -3 -3 -3 -3 -3 -3 -3 -3 -3 09 04 04 04 04 04 09 -3 -3 -3 -3 -3 -3 -3 -3 -3 -3 -3 -3 -3 -3 -3 -3 -3 -3 -3 -3 09 04 04 04 04 09 -3 -3 -3 -3 -3 -3 -3 -3 -3 -3 -3 -3 09 09 09 09 09 09 09 -3 -3 -3 -3 -3 09 04 04 04 04 04 09 -3 -3 -3 -3 -3 -3 -3 -3 -3 -3 09 04 04 04 04 04 09 -3 -3 -3 -3 -3 09 04 04 04 04 04 09 -3 -3 -3 -3 -3 -3 -3 -3 -3 -3 -3 -3 -3 -3 09 04 04 04 04 04 04 09 -3 -3 -3 -3 -3 -3 -3 -3 -3 -3 -3 -3 -3 -3 -3 -3 -3 -3 09 04 04 04 04 04 09 -3 -3 -3 -3 -3 09 04 04 04 04 04 09 -3 -3 -3 -3 -3 -3 -3 -3 -3 -3 -3 -3 -3 -3 -3 -3 -3 09 04 04 04 04 04 04 09 -3 -3 -3 -3 -3 -3 -3 -3 -3 -3 -3 -3 -3 -3 09 04 04 04 04 04 04 09 -3 -3 -3 09 04 04 04 04 04 04 09 -3 -3 -3 -3 -3
-3 -3 -3 -3 -3 09 09 09 04 04 04 04 04 04 09 09 09 -3 -3 -3 -3 -3 -3 -3 -3 -3 -3 09 04 04 04 04 04 09 -3 -3 -3 -3 -3 -3 -3 09 09 09 09 09 09 -3 -3 -3 -3 -3 -3 -3 -3 -3 -3 09 09 09 09 09 09 09 -3 -3 -3 -3 -3 09 04 04 04 04 04 09 -3 -3 -3 -3 -3 -3 -3 -3 -3 -3 -3 -3 -3 -3 -3 -3 -3 -3 -3 -3 09 04 04 04 04 09 -3 -3 -3 -3 -3 -3 -3 -3 -3 -3 -3 -3 09 04 04 04 04 04 04 09 09 09 09 09 04 04 04 04 04 04 09 -3 -3 -3 -3 -3 -3 -3 -3 -3 -3 09 04 04 04 04 04 04 09 09 09 09 09 04 04 04 04 04 04 09 -3 -3 -3 -3 -3 -3 -3 -3 -3 -3 -3 -3 -3 09 04 04 04 04 04 04 09 -3 -3 -3 -3 -3 -3 -3 -3 -3 -3 -3 -3 -3 -3 -3 -3 -3 -3 -3 09 04 04 04 04 04 04 09 09 09 09 09 04 04 04 04 04 04 09 -3 -3 -3 -3 -3 -3 -3 -3 -3 -3 -3 -3 -3 -3 -3 -3 09 04 04 04 04 04 04 09 -3 -3 -3 -3 -3 -3 -3 -3 -3 -3 -3 -3 -3 -3 -3 09 04 04 04 04 04 04 04 09 09 09 04 04 04 04 04 04 04 09 -3 -3 -3 -3 -3
-3 -3 -3 -3 -3 09 04 04 04 04 04 04 04 04 04 04 09 -3 -3 -3 -3 -3 -3 -3 -3 -3 -3 09 04 04 04 04 04 04 09 09 09 09 09 09 09 04 04 04 04 04 09 -3 -3 -3 -3 -3 -3 -3 -3 -3 -3 09 04 04 04 04 04 04 09 09 09 09 09 04 04 04 04 04 04 09 -3 -3 -3 -3 -3 -3 -3 -3 -3 -3 -3 -3 -3 -3 -3 -3 -3 -3 09 09 09 04 04 04 04 09 09 09 -3 -3 -3 -3 -3 -3 -3 -3 -3 -3 -3 09 09 04 04 04 04 04 04 04 04 04 04 04 04 04 09 09 -3 -3 -3 -3 -3 -3 -3 -3 -3 -3 -3 -3 09 09 04 04 04 04 04 04 04 04 04 04 04 04 04 09 09 -3 -3 -3 -3 -3 -3 -3 -3 -3 -3 -3 -3 -3 09 04 04 04 04 04 04 09 -3 -3 -3 -3 -3 -3 -3 -3 -3 -3 -3 -3 -3 -3 -3 -3 -3 -3 -3 -3 -3 09 09 04 04 04 04 04 04 04 04 04 04 04 04 04 09 09 -3 -3 -3 -3 -3 -3 -3 -3 -3 -3 -3 -3 -3 -3 -3 -3 09 04 04 04 04 04 04 09 -3 -3 -3 -3 -3 -3 -3 -3 -3 -3 -3 -3 -3 -3 -3 -3 -3 09 09 04 04 04 04 04 04 04 04 04 04 04 04 04 09 09 -3 -3 -3 -3 -3 -3
-3 -3 -3 -3 -3 09 04 04 04 04 04 04 04 04 04 04 09 -3 -3 -3 -3 -3 -3 -3 -3 -3 -3 09 04 04 04 04 04 04 04 04 04 04 04 04 04 04 04 04 04 04 09 -3 -3 -3 -3 -3 -3 -3 -3 -3 -3 09 04 04 04 04 04 04 04 04 04 04 04 04 04 04 04 09 09 -3 -3 -3 -3 -3 -3 -3 -3 -3 -3 -3 -3 -3 -3 -3 -3 -3 -3 -3 09 04 04 04 04 04 04 04 04 09 -3 -3 -3 -3 -3 -3 -3 -3 -3 -3 -3 -3 -3 09 09 04 04 04 04 04 04 04 04 04 09 09 -3 -3 -3 -3 -3 -3 -3 -3 -3 -3 -3 -3 -3 -3 -3 -3 09 09 04 04 04 04 04 04 04 04 04 09 09 -3 -3 -3 -3 -3 -3 -3 -3 -3 -3 -3 -3 -3 -3 09 04 04 04 04 04 04 09 -3 -3 -3 -3 -3 -3 -3 -3 -3 -3 -3 -3 -3 -3 -3 -3 -3 -3 -3 -3 -3 -3 -3 -3 09 09 04 04 04 04 04 04 04 04 04 09 09 -3 -3 -3 -3 -3 -3 -3 -3 -3 -3 -3 -3 -3 -3 -3 -3 -3 09 04 04 04 04 04 04 09 -3 -3 -3 -3 -3 -3 -3 -3 -3 -3 -3 -3 -3 -3 -3 -3 -3 -3 -3 -3 09 09 04 04 04 04 04 04 04 04 04 09 09 -3 -3 -3 -3 -3 -3 -3 -3
-3 -3 -3 -3 -3 09 09 09 09 09 09 09 09 09 09 09 09 -3 -3 -3 -3 -3 -3 -3 -3 -3 -3 09 09 09 09 09 09 09 09 09 09 09 09 09 09 09 09 09 09 09 09 -3 -3 -3 -3 -3 -3 -3 -3 -3 -3 -3 09 09 09 09 09 09 09 09 09 09 09 09 09 09 09 -3 -3 -3 -3 -3 -3 -3 -3 -3 -3 -3 -3 -3 -3 -3 -3 -3 -3 -3 -3 -3 09 09 09 09 09 09 09 09 09 09 -3 -3 -3 -3 -3 -3 -3 -3 -3 -3 -3 -3 -3 -3 -3 09 09 09 09 09 09 09 09 09 -3 -3 -3 -3 -3 -3 -3 -3 -3 -3 -3 -3 -3 -3 -3 -3 -3 -3 -3 -3 09 09 09 09 09 09 09 09 09 -3 -3 -3 -3 -3 -3 -3 -3 -3 -3 -3 -3 -3 -3 -3 09 09 09 09 09 09 09 09 -3 -3 -3 -3 -3 -3 -3 -3 -3 -3 -3 -3 -3 -3 -3 -3 -3 -3 -3 -3 -3 -3 -3 -3 -3 -3 -3 09 09 09 09 09 09 09 09 09 -3 -3 -3 -3 -3 -3 -3 -3 -3 -3 -3 -3 -3 -3 -3 -3 -3 -3 09 09 09 09 09 09 09 09 -3 -3 -3 -3 -3 -3 -3 -3 -3 -3 -3 -3 -3 -3 -3 -3 -3 -3 -3 -3 -3 -3 -3 09 09 09 09 09 09 09 09 09 -3 -3 -3 -3 -3 -3 -3 -3 -3 -3
-3 -3 -3 -3 -3 -3 -3 -3 -3 -3 -3 -3 -3 -3 -3 -3 -3 -3 -3 -3 -3 -3 -3 -3 -3 -3 -3 -3 -3 -3 -3 -3 -3 -3 -3 -3 -3 -3 -3 -3 -3 -3 -3 -3 -3 -3 -3 -3 -3 -3 -3 -3 -3 -3 -3 -3 -3 -3 -3 -3 -3 -3 -3 -3 -3 -3 -3 -3 -3 -3 -3 -3 -3 -3 -3 -3 -3 -3 -3 -3 -3 -3 -3 -3 -3 -3 -3 -3 -3 -3 -3 -3 -3 -3 -3 -3 -3 -3 -3 -3 -3 -3 -3 -3 -3 -3 -3 -3 -3 -3 -3 -3 -3 -3 -3 -3 -3 -3 -3 -3 -3 -3 -3 -3 -3 -3 -3 -3 -3 -3 -3 -3 -3 -3 -3 -3 -3 -3 -3 -3 -3 -3 -3 -3 -3 -3 -3 -3 -3 -3 -3 -3 -3 -3 -3 -3 -3 -3 -3 -3 -3 -3 -3 -3 -3 -3 -3 -3 -3 -3 -3 -3 -3 -3 -3 -3 -3 -3 -3 -3 -3 -3 -3 -3 -3 -3 -3 -3 -3 -3 -3 -3 -3 -3 -3 -3 -3 -3 -3 -3 -3 -3 -3 -3 -3 -3 -3 -3 -3 -3 -3 -3 -3 -3 -3 -3 -3 -3 -3 -3 -3 -3 -3 -3 -3 -3 -3 -3 -3 -3 -3 -3 -3 -3 -3 -3 -3 -3 -3 -3 -3 -3 -3 -3 -3 -3 -3 -3 -3 -3 -3 -3 -3 -3 -3 -3 -3 -3 -3 -3 -3 -3 -3 -3 -3 -3 -3 -3 -3 -3 -3 -3 -3 -3 -3 -3 -3 -3 -3 -3 -3 -3 -3 -3
-3 -3 -3 -3 -3 -3 -3 -3 -3 -3 -3 -3 -3 -3 -3 -3 -3 -3 -3 -3 -3 -3 -3 -3 -3 -3 -3 -3 -3 -3 -3 -3 -3 -3 -3 -3 -3 -3 -3 -3 -3 -3 -3 -3 -3 -3 -3 -3 -3 -3 -3 -3 -3 -3 -3 -3 -3 -3 -3 -3 -3 -3 -3 -3 -3 -3 -3 -3 -3 -3 -3 -3 -3 -3 -3 -3 -3 -3 -3 -3 -3 -3 -3 -3 -3 -3 -3 -3 -3 -3 -3 -3 -3 -3 -3 -3 -3 -3 -3 -3 -3 -3 -3 -3 -3 -3 -3 -3 -3 -3 -3 -3 -3 -3 -3 -3 -3 -3 -3 -3 -3 -3 -3 -3 -3 -3 -3 -3 -3 -3 -3 -3 -3 -3 -3 -3 -3 -3 -3 -3 -3 -3 -3 -3 -3 -3 -3 -3 -3 -3 -3 -3 -3 -3 -3 -3 -3 -3 -3 -3 -3 -3 -3 -3 -3 -3 -3 -3 -3 -3 -3 -3 -3 -3 -3 -3 -3 -3 -3 -3 -3 -3 -3 -3 -3 -3 -3 -3 -3 -3 -3 -3 -3 -3 -3 -3 -3 -3 -3 -3 -3 -3 -3 -3 -3 -3 -3 -3 -3 -3 -3 -3 -3 -3 -3 -3 -3 -3 -3 -3 -3 -3 -3 -3 -3 -3 -3 -3 -3 -3 -3 -3 -3 -3 -3 -3 -3 -3 -3 -3 -3 -3 -3 -3 -3 -3 -3 -3 -3 -3 -3 -3 -3 -3 -3 -3 -3 -3 -3 -3 -3 -3 -3 -3 -3 -3 -3 -3 -3 -3 -3 -3 -3 -3 -3 -3 -3 -3 -3 -3 -3 -3 -3 -3
-3 -3 -3 -3 -3 -3 -3 -3 -3 -3 -3 -3 -3 -3 -3 -3 -3 -3 -3 -3 -3 -3 -3 -3 -3 -3 -3 -3 -3 -3 -3 -3 -3 -3 -3 -3 -3 -3 -3 -3 -3 -3 -3 -3 -3 -3 -3 -3 -3 -3 -3 -3 -3 -3 -3 -3 -3 -3 -3 -3 -3 -3 -3 -3 -3 -3 -3 -3 -3 -3 -3 -3 -3 -3 -3 -3 -3 -3 -3 -3 -3 -3 -3 -3 -3 -3 -3 -3 -3 -3 -3 -3 -3 -3 -3 -3 -3 -3 -3 -3 -3 -3 -3 -3 -3 -3 -3 -3 -3 -3 -3 -3 -3 -3 -3 -3 -3 -3 -3 -3 -3 -3 -3 -3 -3 -3 -3 -3 -3 -3 -3 -3 -3 -3 -3 -3 -3 -3 -3 -3 -3 -3 -3 -3 -3 -3 -3 -3 -3 -3 -3 -3 -3 -3 -3 -3 -3 -3 -3 -3 -3 -3 -3 -3 -3 -3 -3 -3 -3 -3 -3 -3 -3 -3 -3 -3 -3 -3 -3 -3 -3 -3 -3 -3 -3 -3 -3 -3 -3 -3 -3 -3 -3 -3 -3 -3 -3 -3 -3 -3 -3 -3 -3 -3 -3 -3 -3 -3 -3 -3 -3 -3 -3 -3 -3 -3 -3 -3 -3 -3 -3 -3 -3 -3 -3 -3 -3 -3 -3 -3 -3 -3 -3 -3 -3 -3 -3 -3 -3 -3 -3 -3 -3 -3 -3 -3 -3 -3 -3 -3 -3 -3 -3 -3 -3 -3 -3 -3 -3 -3 -3 -3 -3 -3 -3 -3 -3 -3 -3 -3 -3 -3 -3 -3 -3 -3 -3 -3 -3 -3 -3 -3 -3 -3
-3 -3 -3 -3 -3 -3 -3 -3 -3 -3 -3 -3 -3 -3 -3 -3 -3 -3 -3 -3 -3 -3 -3 -3 -3 -3 -3 -3 -3 -3 -3 -3 -3 -3 -3 -3 -3 -3 -3 -3 -3 -3 -3 -3 -3 -3 -3 -3 -3 -3 -3 -3 -3 -3 -3 -3 -3 -3 -3 -3 -3 -3 -3 -3 -3 -3 -3 -3 -3 -3 -3 -3 -3 -3 -3 -3 -3 -3 -3 -3 -3 -3 -3 -3 -3 -3 -3 -3 -3 -3 -3 -3 -3 -3 -3 -3 -3 -3 -3 -3 -3 -3 -3 -3 -3 -3 -3 -3 -3 -3 -3 -3 -3 -3 -3 -3 -3 -3 -3 -3 -3 -3 -3 -3 -3 -3 -3 -3 -3 -3 -3 -3 -3 -3 -3 -3 -3 -3 -3 -3 -3 -3 -3 -3 -3 -3 -3 -3 -3 -3 -3 -3 -3 -3 -3 -3 -3 -3 -3 -3 -3 -3 -3 -3 -3 -3 -3 -3 -3 -3 -3 -3 -3 -3 -3 -3 -3 -3 -3 -3 -3 -3 -3 -3 -3 -3 -3 -3 -3 -3 -3 -3 -3 -3 -3 -3 -3 -3 -3 -3 -3 -3 -3 -3 -3 -3 -3 -3 -3 -3 -3 -3 -3 -3 -3 -3 -3 -3 -3 -3 -3 -3 -3 -3 -3 -3 -3 -3 -3 -3 -3 -3 -3 -3 -3 -3 -3 -3 -3 -3 -3 -3 -3 -3 -3 -3 -3 -3 -3 -3 -3 -3 -3 -3 -3 -3 -3 -3 -3 -3 -3 -3 -3 -3 -3 -3 -3 -3 -3 -3 -3 -3 -3 -3 -3 -3 -3 -3 -3 -3 -3 -3 -3 -3
-3 -3 -3 -3 -3 -3 -3 -3 -3 -3 -3 -3 -3 -3 -3 -3 -3 -3 -3 -3 -3 -3 -3 -3 -3 -3 -3 -3 -3 -3 -3 -3 -3 -3 -3 -3 -3 -3 -3 -3 -3 -3 -3 -3 -3 -3 -3 -3 -3 -3 -3 -3 -3 -3 -3 -3 -3 -3 -3 -3 -3 -3 -3 -3 -3 -3 -3 -3 -3 -3 -3 -3 -3 -3 -3 -3 -3 -3 -3 -3 -3 -3 -3 -3 -3 -3 -3 -3 -3 -3 -3 -3 -3 -3 -3 -3 -3 -3 -3 -3 -3 -3 -3 -3 -3 -3 -3 -3 -3 -3 -3 -3 -3 -3 -3 -3 -3 -3 -3 -3 -3 -3 -3 -3 -3 -3 -3 -3 -3 -3 -3 -3 -3 -3 -3 -3 -3 -3 -3 -3 -3 -3 -3 -3 -3 -3 -3 -3 -3 -3 -3 -3 -3 -3 -3 -3 -3 -3 -3 -3 -3 -3 -3 -3 -3 -3 -3 -3 -3 -3 -3 -3 -3 -3 -3 -3 -3 -3 -3 -3 -3 -3 -3 -3 -3 -3 -3 -3 -3 -3 -3 -3 -3 -3 -3 -3 -3 -3 -3 -3 -3 -3 -3 -3 -3 -3 -3 -3 -3 -3 -3 -3 -3 -3 -3 -3 -3 -3 -3 -3 -3 -3 -3 -3 -3 -3 -3 -3 -3 -3 -3 -3 -3 -3 -3 -3 -3 -3 -3 -3 -3 -3 -3 -3 -3 -3 -3 -3 -3 -3 -3 -3 -3 -3 -3 -3 -3 -3 -3 -3 -3 -3 -3 -3 -3 -3 -3 -3 -3 -3 -3 -3 -3 -3 -3 -3 -3 -3 -3 -3 -3 -3 -3 -3
-3 -3 -3 -3 -3 -3 -3 -3 -3 -3 -3 -3 -3 -3 -3 -3 -3 -3 -3 -3 -3 -3 -3 -3 -3 -3 -3 -3 -3 -3 -3 -3 -3 -3 -3 -3 -3 -3 -3 -3 -3 -3 -3 -3 -3 -3 -3 -3 -3 -3 -3 -3 -3 -3 -3 -3 -3 -3 -3 -3 -3 -3 -3 -3 -3 -3 -3 -3 -3 -3 -3 -3 -3 -3 -3 -3 -3 -3 -3 -3 -3 -3 -3 -3 -3 -3 -3 -3 -3 -3 -3 -3 -3 -3 -3 -3 -3 -3 -3 -3 -3 -3 -3 -3 -3 -3 -3 -3 -3 -3 -3 -3 -3 -3 -3 -3 -3 -3 -3 -3 -3 -3 -3 -3 -3 -3 -3 -3 -3 -3 -3 -3 -3 -3 -3 -3 -3 -3 -3 -3 -3 -3 -3 -3 -3 -3 -3 -3 -3 -3 -3 -3 -3 -3 -3 -3 -3 -3 -3 -3 -3 -3 -3 -3 -3 -3 -3 -3 -3 -3 -3 -3 -3 -3 -3 -3 -3 -3 -3 -3 -3 -3 -3 -3 -3 -3 -3 -3 -3 -3 -3 -3 -3 -3 -3 -3 -3 -3 -3 -3 -3 -3 -3 -3 -3 -3 -3 -3 -3 -3 -3 -3 -3 -3 -3 -3 -3 -3 -3 -3 -3 -3 -3 -3 -3 -3 -3 -3 -3 -3 -3 -3 -3 -3 -3 -3 -3 -3 -3 -3 -3 -3 -3 -3 -3 -3 -3 -3 -3 -3 -3 -3 -3 -3 -3 -3 -3 -3 -3 -3 -3 -3 -3 -3 -3 -3 -3 -3 -3 -3 -3 -3 -3 -3 -3 -3 -3 -3 -3 -3 -3 -3 -3 -3
-3 -3 -3 -3 -3 -3 -3 -3 -3 -3 -3 -3 -3 -3 -3 -3 -3 -3 -3 -3 -3 -3 -3 -3 -3 -3 -3 -3 -3 -3 -3 -3 -3 -3 -3 -3 -3 -3 -3 -3 -3 -3 -3 -3 -3 -3 -3 -3 -3 -3 -3 -3 -3 -3 -3 -3 -3 -3 -3 -3 -3 -3 -3 -3 -3 -3 -3 -3 -3 -3 -3 -3 -3 -3 -3 -3 -3 -3 -3 -3 -3 -3 -3 -3 -3 -3 -3 -3 -3 -3 -3 -3 -3 -3 -3 -3 -3 -3 -3 -3 -3 -3 -3 -3 -3 -3 -3 -3 -3 -3 -3 -3 -3 -3 -3 -3 -3 -3 -3 -3 -3 -3 -3 -3 -3 -3 -3 -3 -3 -3 -3 -3 -3 -3 -3 -3 -3 -3 -3 -3 -3 -3 -3 -3 -3 -3 -3 -3 -3 -3 -3 -3 -3 -3 -3 -3 -3 -3 -3 -3 -3 -3 -3 -3 -3 -3 -3 -3 -3 -3 -3 -3 -3 -3 -3 -3 -3 -3 -3 -3 -3 -3 -3 -3 -3 -3 -3 -3 -3 -3 -3 -3 -3 -3 -3 -3 -3 -3 -3 -3 -3 -3 -3 -3 -3 -3 -3 -3 -3 -3 -3 -3 -3 -3 -3 -3 -3 -3 -3 -3 -3 -3 -3 -3 -3 -3 -3 -3 -3 -3 -3 -3 -3 -3 -3 -3 -3 -3 -3 -3 -3 -3 -3 -3 -3 -3 -3 -3 -3 -3 -3 -3 -3 -3 -3 -3 -3 -3 -3 -3 -3 -3 -3 -3 -3 -3 -3 -3 -3 -3 -3 -3 -3 -3 -3 -3 -3 -3 -3 -3 -3 -3 -3 -3
-3 -3 -3 -3 -3 -3 -3 -3 -3 -3 -3 -3 -3 -3 -3 -3 -3 -3 -3 -3 -3 -3 -3 -3 -3 -3 -3 -3 -3 -3 -3 -3 -3 -3 -3 -3 -3 -3 -3 -3 -3 -3 -3 -3 -3 -3 -3 -3 -3 -3 -3 -3 -3 -3 -3 -3 -3 -3 -3 -3 -3 -3 -3 -3 -3 -3 -3 -3 -3 -3 -3 -3 -3 -3 -3 -3 -3 -3 -3 -3 -3 -3 -3 -3 -3 -3 -3 -3 -3 -3 -3 -3 -3 -3 -3 -3 -3 -3 -3 -3 -3 -3 -3 -3 -3 -3 -3 -3 -3 -3 -3 -3 -3 -3 -3 -3 -3 -3 -3 -3 -3 -3 -3 -3 -3 -3 -3 -3 -3 -3 -3 -3 -3 -3 -3 -3 -3 -3 -3 -3 -3 -3 -3 -3 -3 -3 -3 -3 -3 -3 -3 -3 -3 -3 -3 -3 -3 -3 -3 -3 -3 -3 -3 -3 -3 -3 -3 -3 -3 -3 -3 -3 -3 -3 -3 -3 -3 -3 -3 -3 -3 -3 -3 -3 -3 -3 -3 -3 -3 -3 -3 -3 -3 -3 -3 -3 -3 -3 -3 -3 -3 -3 -3 -3 -3 -3 -3 -3 -3 -3 -3 -3 -3 -3 -3 -3 -3 -3 -3 -3 -3 -3 -3 -3 -3 -3 -3 -3 -3 -3 -3 -3 -3 -3 -3 -3 -3 -3 -3 -3 -3 -3 -3 -3 -3 -3 -3 -3 -3 -3 -3 -3 -3 -3 -3 -3 -3 -3 -3 -3 -3 -3 -3 -3 -3 -3 -3 -3 -3 -3 -3 -3 -3 -3 -3 -3 -3 -3 -3 -3 -3 -3 -3 -3
-3 -3 -3 -3 -3 -3 -3 -3 -3 -3 -3 -3 -3 -3 -3 -3 -3 -3 -3 -3 -3 -3 -3 -3 -3 -3 -3 -3 -3 -3 -3 -3 -3 -3 -3 -3 -3 -3 -3 -3 -3 -3 -3 -3 -3 -3 -3 -3 -3 -3 -3 -3 -3 -3 -3 -3 -3 -3 -3 -3 -3 -3 -3 -3 -3 -3 -3 -3 -3 -3 -3 -3 -3 -3 -3 -3 -3 -3 -3 -3 -3 -3 -3 -3 -3 -3 -3 -3 -3 -3 -3 -3 -3 -3 -3 -3 -3 -3 -3 -3 -3 -3 -3 -3 -3 -3 -3 -3 -3 -3 -3 -3 -3 -3 -3 -3 -3 -3 -3 -3 -3 -3 -3 -3 -3 -3 -3 -3 -3 -3 -3 -3 -3 -3 -3 -3 -3 -3 -3 -3 -3 -3 -3 -3 -3 -3 -3 -3 -3 -3 -3 -3 -3 -3 -3 -3 -3 -3 -3 -3 -3 -3 -3 -3 -3 -3 -3 -3 -3 -3 -3 -3 -3 -3 -3 -3 -3 -3 -3 -3 -3 -3 -3 -3 -3 -3 -3 -3 -3 -3 -3 -3 -3 -3 -3 -3 -3 -3 -3 -3 -3 -3 -3 -3 -3 -3 -3 -3 -3 -3 -3 -3 -3 -3 -3 -3 -3 -3 -3 -3 -3 -3 -3 -3 -3 -3 -3 -3 -3 -3 -3 -3 -3 -3 -3 -3 -3 -3 -3 -3 -3 -3 -3 -3 -3 -3 -3 -3 -3 -3 -3 -3 -3 -3 -3 -3 -3 -3 -3 -3 -3 -3 -3 -3 -3 -3 -3 -3 -3 -3 -3 -3 -3 -3 -3 -3 -3 -3 -3 -3 -3 -3 -3 -3